














SO     texture/wall_south.xpm






EA    texture/wall_east.xpm

      F      044, 044 ,3

C       144 ,044, 34
NO      texture/wall_north.xpm
WE     texture/wall_west.xpm

111111111111111111111111111111111
10000000001100000000000000000001
10110000011100000000000000000001
1010000000000000000000W010000001
10110000011100000000000000000001
10000000000110000000111011110001
11110111111111110111000000010001
11110111111111110111010100000001
11000000110101101100000000000001
10000000000000000000000000000001
10000000000000001101010010000001
11000000110101101111110111110001
11110111111110101111110111110001
111111111111111111111111111111111