














SO     1






EA    1

      F      244, 244, 244

C       144, 244, 244
NO      1
WE     1

1111111111111
1000000000001         11111
1000000000001        1000001
1000011100001        111001
1000000000001        111111
1000000S000011
1000000000001
1000000000001
1000000000001
1000000000001
1000000000001
1111111111111
11111111 111
1111111 1111
1111 1111111
