














SO     1






EA    1

      F      244 244 344

C       144 244 344
NO      1
WE     1
111111
1111111
1111111
