














SO     1






EA    1

      F      244, 244, 244

C       144, 244, 244
NO      1
WE     1

1111111111111
1000000000001
1000000000001           111
1000000000001        1111S1
1000000000001        111111
10000000000011
1000000000001
1000000000001
1000000000001
1000000000001
1000000000001
1111111111111
111111111111
111111111111
1111 1111111