














SO     1






EA    1

      F      244 244 344

C       144 244 344
NO      1
WE     1

111111111111111111111111
100000000000000000000001
100000000000000000000001
100011111100000000000001
100000000100000000000001
100011111100000000000001
100000000100000000000001
1000000N0000000000000001
100000000000000000000001
100000000000000000000001
100000000000000000000001
100000000000000000000001
100000000000000000000001
100000000000000000000001
100000000000000000000001
111111111111111111111111