














SO     1






EA    1

      F      244, 244, 244

C       144, 244, 244
NO      1
WE     1

11111 1111111
1000000000001
1000000000001
1000000000001        11111
1001111111001        111111
100100S0010011
1000111110001
1000000000001
1000000000001
1000000000001
1000000000001
1111111111111
